Billie Eilish - "everything i wanted"
Coldplay - "Fix You"
이문세 - "옛사랑"
박효신 - "야생화"
Adele - "Someone Like You"
BTS - "Dynamite"
Pharrell Williams - "Happy"
Red Velvet - "Red Flavor"
Maroon 5 - "Moves Like Jagger"
아이유 - "삐삐"
John Mayer - "Gravity"
Bruno Mars - "The Lazy Song"
Jack Johnson - "Banana Pancakes"
자이언티 - "양화대교"
헤이즈 - "비도 오고 그래서"
Queen - "The Show Must Go On"
Adele - "Rolling in the Deep"
방탄소년단 - "Blood Sweat & Tears"
Lady Gaga - "Bad Romance"
이수 - "My Way"
Ed Sheeran - "Perfect"
아이유 - "금요일에 만나요"
제이슨 므라즈 - "I'm Yours"
AKMU - "200%"
샘김 - "Love Me Like That"
Lana Del Rey - "Summertime Sadness"
백예린 - "Square (2017)"
The xx - "Intro"
검정치마 - "기다린만큼, 더"
Lorde - "Royals"